3 1 1 4 1 1 1 1 1 1 1 1 1 1 1 2
8 0 0 0 0 0 0 0 0 0 0 0 0 0 0 9
8 0 0 0 0 0 0 0 0 0 0 0 0 0 0 9
8 0 0 0 0 0 0 0 0 0 0 0 0 0 0 9
8 0 0 0 0 0 0 0 0 0 0 0 0 0 0 9
8 0 0 0 0 0 0 0 0 0 0 0 0 0 0 9
8 0 0 0 0 0 0 0 0 0 0 0 0 0 0 9
8 0 0 0 0 0 0 0 0 0 0 0 0 0 0 9
8 0 0 0 0 0 0 0 0 0 0 0 0 0 0 9
8 0 0 0 0 0 0 0 0 0 0 0 0 0 0 9
8 0 0 0 0 0 0 0 0 0 0 0 0 0 0 9
6 1 4 1 1 1 10 0 0 11 1 1 1 4 1 7